4444444444444444444444
4910000010149100000004
4022144240204400000004
4441491242000000000004
4440444142424444444444
4440000012421900000004
4444444402804000000004
4444444444444000000004
4000000000000000000004
4000000000000000000004
4000000000000000000004
4444444444444444444444