44444444444444444444444444444
40000000000000000000000000004
40000000000000000000000000004
40000000000000000000000000004
40000000000000000000000000004
41111111111111111111111111114
40000000000000000000000000004
40000000000000000000000000004
40000000000000000000000000004
40000000000000000000000000004
44444444444444444444444444444