44444444444444444444444444444
49000000000000000000000000094
40000500000000000007000000004
40000000000000000000000000004
40000000000008000000000000004
41111111111111111111111111114
40000000000000000000000000004
40000000000020000000000000004
40000000000027000000000000004
40000000000020000000000000004
40000000000000000000000000004
49000000000000000000000000094
44444444444444444444444444444