4444444444444444444444
4900000000000000000094
4000000000000000000004
4000000000000000000004
4000000050000000000004
4000000000800000000004
4000600000000000000004
4000000000322220000004
4000000000010220000004
4444444444400020000004
4905456665400010000094
4444444444444444444444