4444444444444444444444
4910000010144400000004
4022144240204414444144
4441491242000020000294
4440444142424444444044
4440000012421900000004
4444444402804000000004
4444444444444000000004
4000000000000000000004
4000000000000000000004
4000000000000000000004
4444444444444444444444