444444444
490000094
400080004
490000094
444444444