4444444444444444444444
4444444444444001002044
4440000010144664666694
4442144240204666666644
4441491242000200004004
4440444142424444444444
4440000012421900000004
4444444402804000660004
4444444444444000000004
4000000000000000000004
4000000000000000000004
4444444444444444444444