4444444444444
4900000000094
4000000000004
4111111111114
4000800000004
4900000000094
4444444444444