4444444444444444444444
4904000004000000000004
4020444210000000000004
4122910202000000000004
4412244142000000000004
4440000012440000000004
4444444402840000000004
4000000004440000000004
4000000000000000000004
4000000000000000000004
4000000000000000000004
4444444444444444444444