4444444444444444444444
4900000000000000000094
4000000000000000000004
4000000000000000000004
4000000000000000000004
4000000000000000000004
4000850000000000000004
4000000000000000000004
4000000000000000000004
4444444444400000000004
4905456665400000000094
4444444444444444444444