4444444444444444444444444444444444444444444444444
4000000000000000000000000000000000000000000000004
4000000000000000000000000000000000000000000000004
4000000000000000000000000000000000000000000000004
4000000000000000000000000000000000000000000000004
4000000000000000000000000000000000000000000000004
4000000000000000000000000000000000000000000000004
4111111111111111111111111111111111111111111111114
4000000000000000000000000000000000000000000000004
4000000000000000000000000000000000000000000000004
4000000000000000000000000000000000000000000000004
4000000000000000000000000000000000000000000000004
4444444444444444444444444444444444444444444444444